########################################################################################################################
#0000000000000000000000000000000000000000000000000000000000000000000000000000000000000000000000000000000000000000000000#
#0000000000000000000000000000000000000000000000000000000000000000000000000000000000000000000000000000000000000000000000#
#0000000000000000000000000000000000000000000000000000000000000000000000000000000000000000000000000000000000000000000000#
#000000000000000000000000000000000000000000000000000000000000000000000000l000000000000000000000000000000000000000000000#
#00000000000000000000000000000000000000000000000000000000000000122222222&l000000000000000000000000000000000000000000000#
#0000000000000000000000000000000000000000000000000000000l0c0000955g444447l000000000000000000000000000000000000000000000#
#0000000000000000000000000000000000000000000000000000000l122222!5g^000000l000000000000000000000000000000000000000000000#
#0000000000000000000000000000000000000000000000000000000l9555555g^0000000l000000000000000000000000000000000000000000000#
#000000000000000000000000a0y0000000000000000000000000000l955j55g^00000000l000000000000000000000000000000000000000000000#
#0000000000000000000000001222&00000000000000000000000000l95555g^000000000l000000000000000000000000000000000000000000000#
#000000000000000a0t0000009555800c00122&00000000000000000l955558c00b00y000l000000000000000000000000000000000000000000000#
#0000000000000001222&<-->k6j5?22222!558000000000000001222!5555?2222222222&000000000000000000000000000000000000000000000#
#0000000l00c0000955580000036555j5555558at0b00f0h000009555555%555g444444447000000000000000000000000000000000000000000000#
#0000000l1222222!5%5800000036555555555?22222222222222!5j55g44444^000000000000000000000000000000000000000000000000000000#
#0000000l3446555555580000000365555@55555555555%55555g44444^000000000000000000000000000000000000000000000000000000000000#
#0000000l0003446@55580000000034444444444444444444444^00q000000000000000000000000000000000000000000000000000000000000000#
#0000000l0000003444470000000000q00000000000000000000000q000000000000000000000000000000000000000000000000000000000000000#
#0000000l0000000000000000000000q00000000000000000000000q000000000000000000000000000000000000000000000000000000000000000#
#0000000l0000000000000b000t0000q00000000000000l000b0000q000l00000000000000000000000000000000000000000000000000000000000#
#00l0t00l0000000000012222222222w22&00000000000l12222222w22&l00000000000000000000000000000000000000000000000000000000000#
#00l122&00000000000034444444444444^00000000000l344444655558l00000000000000000000000000000000000000000000000000000000000#
#00l344^00000000000000000000000000000000000000l000000344447l00000000000000000000000000000000000000000000000000000000000#
#00l000000000000000000000000000000000000000000l000000000000l00000000000000000000000000000000000000000000000000000000000#
#00l00000000000000000000000000000c000000000000l00000000000clacaabcaabcaba00h0000000000000000000000000000000000000000000#
#00l0000000000000000000012&<--->1222&000000000l00000000001222222222222222222222222222222222222222222222222222222222222&#
#00l000000000000000000009580000095558000y00000l000000000095555555555555555555g444444446555555555555555555g4444444444447#
#12222&00000000000012222!58000009555?22222222&<--------->9555555555555555555g^00000000365555555555555555g^0000000000000#
#955558000001222222!555@55800000k65555555555g^00000000000344655555555555555g^00000000003655555555555555g^00000000000000#
#95555?22222!555g4444444447000000k655555555g^000000000000000344444444444444^000000000000344444444444444^000000000000000#
#k4446j5555g4444^00000000000000000k6555555g^000000000000000000q0000000000q0000000000000000q0000000000q00000000000000000#
#000095555g^00000000000000000000000955555580000000000000000000q0000000000q0000000000000000q0000000000q00000000000000000#
#00009555%8000000000000000000000000955555580000000000000000000q0000000000q0000000000000000q0000000000q00000000000000000#
#1222!5555?222222222222222222222222!555555?2222222222222222222w2222222222w2222222222222222w2222222222w22222222222222222#
#95%555555555@555555%55555555555@55555555555555555555555555555555555555555555555555555555555555555555555555555555555558#
#95555@555555555555555555j555555555555555555555555555555555555555555555555555555555555555555555555555555555555555555558#
#95555555555555555@5555555555555555555555555555555555555555555555555555555555555555555555555555555555555555555555555558#
#9555555555555555555555555555555555555555555555555555555555555555555555555555555555555555555555555555555555555555555558#
#9555555555555555555555555555555555555555555555555555555555555555555555555555555555555555555555555555555555555555555558#
#9555555555555555555555555555555555555555555555555555555555555555555555555555555555555555555555555555555555555555555558#